25 25
& . . . . + * . . . + & . . * . . . . . . . . . &
. . * . . . + . . * . . . . + . . * . . . + . . .
. . . * . . . . . . + . . * . . + . . . . . . . .
. * + . . . . * + . . * . . . . . . . + . . . . *
. + . . . + . . . . . + . . . + * . . . . . * . .
+ * . . . . . . * . . . . . . * . . . . + * . . .
. . . . * . . + . . . . * . + . * . . . + . . . .
. . . * . + . . * + * . . . . * . . . . + . * . .
. . * . . . . * . . + . . . * . . . . . * + . . .
. . + . . * . . . . . * . . + . . * . . . . . * .
. . . * . . + * . + . * . . . . + . . . + * . . .
& . * . . . . . . . . . + . . . * . . + . . . * .
+ . . . * . . . . . . * . . . + . . . . * . . . &
. . . . . . + . . . * . . + . . . * . + . . . . *
. * + . . * . . . . * . . . . * . . . . . . . . .
. . . . . . . + * . . * . . + . * * * + . . . . .
. . + . . . * . . . . + . . . . . . . . * . + . .
. . * + . . . * . . + . . . * . + . . . . * . . .
. . . * . . + . . * . * . . . . . . + . . + . . .
. . . + . . . . * . . + . . . * . . * . . . * . *
. * . . . * . + . . . . * . . . + . * . . . . . .
. . . . * + . . . * . . + . . * . . . * . + . . .
. + . . * . . . * . . . . . . . + * + . * . * . .
. * . . . * . + . . . + . * . . . . * . . . . . .
+ . & . . + . . * . . . & . . * . . + . . * . . &