10 10
+ # . # + + # . # +
# # . # # # # . # #
. . & # . . # & . .
# # # # # # # # # #
+ # . # + + # . # +
+ # . # + + # . # +
# # # # # # # # # #
. . & # . . # & . .
# # . # # # # . # #
+ # . # + + # . # +