24 24
& # # # # # # # # # # # # # # # # # # # # # # &
# . . . . . . . . . . . . . . . . . . . . . . #
# . # . # . # . # . # . . # . # . # . # . # . #
# . . . . . . . . . . . . . . . . . . . . . . #
# . # . # . # . # . # . . # . # . # . # . # . #
# . . . . . . . . . . . . . . . . . . . . . . #
# . # . # . # . # . # . . # . # . # . # . # . #
# . . . . . . . . . . . . . . . . . . . . . . #
# . # . # . # . # . # . . # . # . # . # . # . #
# . . . . . . . . . . . . . . . . . . . . . . #
# . # . # . # . # . # . . # . # . # . # . # . #
# . . . . . . . . . . + + . . . . . . . . . . #
# . . . . . . . . . . + + . . . . . . . . . . #
# . # . # . # . # . # . . # . # . # . # . # . #
# . . . . . . . . . . . . . . . . . . . . . . #
# . # . # . # . # . # . . # . # . # . # . # . #
# . . . . . . . . . . . . . . . . . . . . . . #
# . # . # . # . # . # . . # . # . # . # . # . #
# . . . . . . . . . . . . . . . . . . . . . . #
# . # . # . # . # . # . . # . # . # . # . # . #
# . . . . . . . . . . . . . . . . . . . . . . #
# . # . # . # . # . # . . # . # . # . # . # . #
# . . . . . . . . . . . . . . . . . . . . . . #
& # # # # # # # # # # # # # # # # # # # # # # &
