24 24
& * . . . . . . . . . . . . . . . . . * & + + +
. * . . . . . . . . . . . . . . . . . * . * + +
. * . . . . . . . . . . . . . . . . . * . * * *
. * . . . . . . . . . . . . . . . . . * . . . .
. * . . . . . . . . . . . . . . . . . * * * * .
. * . . . . . . . . . . . . . . . . . . . . . .
. * . . . . . . . . . . . . . . . . . . . . . .
. . . . . . . . . . . . . . . . . . . . . . . .
. . . . . . . . . . . . . . . * * * * * . * * *
. . . . . . . . . + . . . . . * . . . * . . . .
. . . . . . . . . . . . . * * * . * . * * * * .
. * * . . . . . . . . . . * . . . * . . . . . .
. . . . . . . . . . . . . * . * * * * * * * * *
. . . . . . . . . . . . . * . * . . . . . . . *
. . . . . . . . . . . . . * . * . * * * * * . *
. * . . . . . . . . . . . * . * . * . . . * . .
. * . . . . . . . . . . . * . * . * . * . * * .
. * . . . . . . . . . . . * . * . * . * . . . .
. * . . . . . . . . . . . * . * . * . * * * * *
. * . . . . . . . . . . . * . * . * . * . . . .
. * . . . . . . . . . . . * . * . * . * . * * .
. * . . . . . . . . . . . * . * . * . * . * . .
. * . . . . . . . . . . . * . * . * . * . * . *
& * . . . . . . . . . . . * . . . * . . . * . &
