15 15
& & & & & & # * # & & & & & &
& & & & & & # * # & & & & & &
& & & & & & # * # & & & & & &
& & & & & & # * # & & & & & &
& & & & & & # * # & & & & & &
& & & & & & # * # & & & & & &
# # # # # # # * # # # # # # #
* * * * * * * # * * * * * * *
# # # # # # # * # # # # # # #
& & & & & & # * # & & & & & &
& & & & & & # * # & & & & & &
& & & & & & # * # & & & & & &
& & & & & & # * # & & & & & &
& & & & & & # * # & & & & & &
& & & & & & # * # & & & & & &
