15 15
& & & & & & # * # & & & & & &
& & & & & & # * # & & & & & &
& & & & & & # * # & & & & & &
& & & & & & # * # & & & & & &
& & & & & & # * # & & & & & &
& & & & & & # * # & & & & & &
# # # # # # # * # # # # # # #
* * * * * * * * * * * * * * *
# # # # # # # * # # # # # # #
& & & & & & # * # & & & & & &
& & & & & & # * # & & & & & &
& & & & & & # * # & & & & & &
& & & & & & # * # & & & & & &
& & & & & & # * # & & & & & &
& & & & & & # * # & & & & & &