40 40
. . + + + * + + + * . . . . . . . . . . . . . . . . . . . . . . . . . . . . . .
. . + + + * + . + * . . . . . . . . . . . . . . . . . . . . . . . . . # * . . .
. . + + + * # . # * . . . . . . . . . . . . . . . . . . . . . . . . . # * . . .
. . . . . . . . . * . . . . . . . . . . . . . . . . . . . . . . . . . # * . . .
* * * * * * * * . * . . . . . . . . . . . . . . . . . . . . . . . . . # * + . .
. . . . . . . . . * . . . . . . . . . . . . . . . . . . . . . . . . . # * + . .
. . . . . . . . . # . . . . . . . . . . . . . . . . . . . . . . . . . # * + + +
# * # * # * # * . * . . . . . . . . . . . . . . . . . . . . . . . . . # * * * *
. . . . . . . . . # . . . . . . . . . . . . . . . . . . . . . . . . . # # # # #
* # * . * # * # * # . . . . . . . . . . . . . . . . . . . . . . . . . . . . . .
. . . . . . . . . . . . . . . . . . . . . . . . . . . . . . . . . . . . . . . .
. . . . . . . . . . . . . . . . . . . . . . . . . . . . . . . . . . . . . . . .
. . . . . . . . . . . . . . . . . . . . . . . . . . . . . . . . . . . . . . . .
. . . . . . . . . . . . . . . . . . . . . . . . . . . . . . . . . . . . . . . .
. . . . . . # # # . . . . . . . . . . . . . . . . . . . . . . . . . . . . . . .
. . . . . . # * # . . . . . . . . . . . . . . . . . . . . . . . . . . . . . . .
. . . . . . # # # . . . . . . . * # * * * * # * . . . . . . . . . . . . . . . .
. . . . . . . . . . . . . . . . # . # . . # . # . . . . . . . . # # # . . . . .
. . . . . . . . . . . . . . . . * # * + . * # * . . . . . . . . # * # . . . . .
. . . . . . . . . . . . . . . . * . . . . + . * . . . . . . . . # # # . . . . .
. . . . . . . . . . . . . . . . * . + . . . . * . . . . . . . . . . . . . . . .
. . . . . . . . . . . . . . . . * # * . + * # * . . . . . . . . . . . . . . . .
. . . . . . . . . . . . . . . . # . # . . # . # . . . . . . . . . . . . . . . .
. . . . . . . . . . . . . . . . * # * * * * # * . . . . . . . . . . . . . . . .
. . . . # # # . . . . . . . . . . . . . . . . . . . . . . . . . . . . . . . . .
. . . . # * # . . . . . . . . . . . . . . . . . . . . . . . . . . . . . . . . .
. . . . # # # . . . . . . . . . . . . . . . . . . . . . . . . . . . . . . . . .
. . . . . . . . . . . . . . . . . . . . . . . . . . . . . . . . . . . . . . . .
. . . . . . . . . . . . . . . . . . . . . . . . . . . . . . . . . . . . . . . .
. . . . . . . . . . . . . . . . . . . . . . . . . . . . . . . . . . . . . . . .
. . . . . . . . . . . . . . . . . . . . . . . . . . . . . . # * # * # * . * # *
# # # # # . . . . . . . . . . . . . . . . . . . . . . . . . # . . . . . . . . .
* * * * # . . . . . . . . . . . . . . . . . . . . . . . . . * . * # * # * # * #
+ + + * # . . . . . . . . . . . . . . . . . . . . . . . . . # . . . . . . . . .
. . + * # . . . . . . . . . . . . . . . . . . . . . . . . . * . . . . . . . . .
. . + * # . . . . . . . . . . . . . . . . . . . . . . . . . * . * * * * * * * *
. . . * # . . . . . . . . . . . . . . . . . . . . . . . . . * . . . . . . . . .
. . . * # . . . . . . . . . . . . . . . . . . . . . . . . . * # . # * + + + . .
. . . * # . . . . . . . . . . . . . . . . . . . . . . . . . * + . + * + + + . .
. . . . . . . . . . . . . . . . . . . . . . . . . . . . . . * + + + * + + + . .