32 32
. * . . . . . * . * . . . * . . . . . . . . . # * . * . . * + +
. . . . * . # . . . . * . . . * . . . . . . * . . . . * . . * +
* . . * . . . . * . . . . # . . * . . . . . . . . * . . # . . . 
. . . # . * . . . * . . * . * . . . . . . . . * . . * . * * . * 
. . * . . . . * . . . . . . . . * . . . . . . . . . . . . . . . 
* . . . * # # # # # * . . * . . . . . . . . . . * . * . * . * . 
. . * . . # * + * # . * . . . * . . . . . . . . . . # . . . # . 
. # . . . # + + + . . . . . . # . * . . . . . . . * . * . * . * 
* * . . * # * + & & . # # . * . . . . . . . . . . . * . . . . . 
* . . . . # # . & & + * # . . * . . . . . . . . . . . . * . . * 
. . . * . . . . . + + + # * . . . . * . . . . . . * . * . . . . 
. * . . . * . . # * + * # . . . * . . . . . . . . . . . . * # . 
. . . * . . * . # # # # # . * . # . * . . . . . . . * . * . * . 
. . * . . . . . . * . . . . . . . * . * . . . . . . . . . . . . 
* # . . . * . * . . . . * . . * . . . . . . . . . . . * . * . . 
. . * . . . . . . * . . . . . . . . * . * . . . . . . . . . . * 
. . . . * . . . . . . * . . * . . . . . . . . . . . . . * . . . 
. * . . . # . * . . . . . . # . . * . * . . . . . . . . . . * . 
. . . * . * . . # . * . . * . . . . . . # * . . . . . . * . . . 
. * . . . . . * . . . . . . . . * . * . . . . . . . . . . . . * 
. . # * . . . . . * . * . . * . . . . * . . * . . . . . . . * # 
* . . . . * . * . . . . * . . . * # . . * . . . . . . . . . . . 
. . * . . . # . . * . # . . * . . . * . . . . * . . . . . . * . 
* . . . * . . * . . . * . . . . . * . . . * . . . . . . . . . . 
. . . . . . . . . . . . . * # * . . . * . . . . . . . . . . . * 
. # # # . # # # . . * . . . . . . * . . . # * . . . . . . . . . 
. # . # . # . # . . . . * . * . . . . * . . . . * . . . . . . . 
. . . . . . . . . . . . . . . . * . . . . * . . . . . . . . . . 
* * * * * . # # . . . * # * . . . . * . . . . . . . . . . . . . 
. . . . . . . # . . . . . . . * . . . . * . . * . * . . . . . . 
& & & & * . # # . . * . * . . . . * # . . . * . . . . . . . . .
+ + + + * . . . . . . . . . * . . . . * . . . . * . * . . . . &