32 32
& * . . . . . * . * . . . * . . . . . . . . . # * . * . . * + +
. . . . * . # . . . . * . . . * . . . . . . * . . . . * . & * +
* . . * . . . . * . . . . # . . * . . . . . . . . * . . # . . . 
. . . # . * . . . * . . * . * . . . . . . . . * . . * . * * . * 
. . * . . . . * . . . . . . . . * . . . . . . . . . . . . . . . 
* . . . * # # # # # * . . * . . . . . . . . . . * . * . * . * . 
. . * . . # * + * # . * . . . * . . . . . . . . . . # . . . # . 
. # . . . # + + + . . . . . . # . * . . . . . . . * . * . * . * 
* * . . * # * + . . . # # . * . . . . . . . . . . . * . . . . . 
* . . . . # # . . . + * # . . * . . . . . . . . . . . . * . . * 
. . . * . . . . . + + + # * . . . . * . . . . . . * . * . . . . 
. * . . . * . . # * + * # . . . * . . . . . . . . . . . . * # . 
. . . * . . * . # # # # # . * . # . * . . . . . . . * . * . * . 
. . * . . . . . . * . . . . . . . * . * . . . . . . . . . . . . 
* # . . . * . * . . . . * . . * . . . . . . . . . . . * . * . . 
. . * . . . . . . * . . . . . . . . * . * . . . . . . . . . . * 
. . . . * . . . . . . * . . * . . . . . . . . . . . . . * . . . 
. * . . . # . * . . . . . . # . . * . * . . . . . . . . . . * . 
. . . * . * . . # . * . . * . . . . . . # * . . . . . . * . . . 
. * . . . . . * . . . . . . . . * . * . . . . . . . . . . . . * 
. . # * . . . . . * . * . . * . . . . * . . * . . . . . . . * # 
* . . . . * . * . . . . * . . . * # . . * . . . . . . . . . . . 
. . * . . . # . . * . # . . * . . . * . . . . * . . . . . . * . 
* . . . * . . * . . . * . . . . . * . . . * . . . . . . . . . . 
. . . . . . . . . . . . . * # * . . . * . . . . . . . . . . . * 
. # # # . # # # . . * . . . . . . * . . . # * . . . . . . . . . 
. # . # . # . # . . . . * . * . . . . * . . . . * . . . . . . . 
. . . . . . . . . . . . . . . . * . . . . * . . . . . . . . . . 
* * * * * . # # . . . * # * . . . . * . . . . . . . . . . . . . 
. . . . . . . # . . . . . . . * . . . . * . . * . * . . . . . . 
& . . . * . # # . . * . * . . . . * # . . . * . . . . . . . . .
+ + + + * . . . . . . . . . * . . . . * . . . . * . * . . . . &