. . . . . . . * . . . . . . . . . * . . . . . . .
. . . . . . . * . . . . . . . . . * . . . . . . .
. . . . . . . * . . . . . . . . . * . . . . . . .
. . . . . . . * . . . . . . . . . * . . . . . . .
. . . . . . . * . . . . . . . . . * . . . . . . .
. . . . . . . * . . . . . . . . . * . . . . . . .
. . . . . . . * . . . . . . . . . * . . . . . . .
. . . . . . . * . . . . . . . . . * . . . . . . .
. . . . . . . * . . . . . . . . . * . . . . . . .
. . . . . . . * . . . . . . . . . . . . . . . . .
. . . . . . . * . . . . . . . . . . . . . . . . .
. . . . . . . * . . . . . . . . . . . . . . . . .
. . . . . . . * . . . . . . . . . * . . . . . . .
. . . . . . . . . . . . . . . . . * . . . . . . .
. . . . . . . . . . . . . . . . . * . . . . . . .
. . . . . . . . . . . . . . . . . * . . . . . . .
. . . . . . . * . . . . . . . . . * . . . . . . .
. . . . . . . * . . . . . . . . . * . . . . . . .
. . . . . . . * . . . . . . . . . * . . . . . . .
. . . . . . . * . . . . . . . . . * . . . . . . .
. . . . . . . * . . . . . . . . . * . . . . . . .
. . . . . . . * . . . . . . . . . * . . . . . . .
. . . . . . . * . . . . . . . . . * . . . . . . .
. . . . . . . * . . . . . . . . . * . . . . . . .
. . . . . . . * . . . . . . . . . * . . . . . . .