25 25
& . . . . . . * . . . . . . . . . * . . . . . . &
. . . . . . . * . . . . . . . . . * . . . . . . .
. . . . . . . * . . . . . . . . . * . . . . . . .
. . . . . . . * . . . . . . . . . * . . . . . . .
. . . . . . . * . . . . . . . . . * . . . . . . .
. . . . . . . * . . . . . . . . . * . . . . . . .
. . . . . . . * . . . . . . . . . * . . . . . . .
. . . . . . . * . . . . . . . . . * . . . . . . .
. . . . . . . * . . . . . . . . . * . . . . . . .
. . . . . . . * . . . . . . . . . # . . . . . . .
. . . . . . . * . . . . . . . . . # . . . . . . .
. . . . . . . * . . . . . . . . . # . . . . . . .
. . . . . . . * # # # # # # # # # * . . . . . . .
. . . . . . . # . . . . . . . . . * . . . . . . .
. . . . . . . # . . . . . . . . . * . . . . . . .
. . . . . . . # . . . . . . . . . * . . . . . . .
. . . . . . . * . . . . . . . . . * . . . . . . .
. . . . . . . * . . . . . . . . . * . . . . . . .
. . . . . . . * . . . . . . . . . * . . . . . . .
. . . . . . . * . . . . . . . . . * . . . . . . .
. . . . . . . * . . . . . . . . . * . . . . . . .
. . . . . . . * . . . . . . . . . * . . . . . . .
. . . . . . . * . . . . . . . . . * . . . . . . .
. . . . . . . * . . . . . . . . . * . . . . . . .
& . . . . . . * . . . . . . . . . * . . . . . . &
