8 8
. . * . . * . &
. . * . . * . .
. . * . . * . .
. . * . . . . .
. . . . . * . .
. . * . . * . .
. . * . . * . .
& . * . . * . .