25 25
. . . . . . . * . . . . . . . . . * . . . . . . &
. . . . . . . * . . . . . . . . . * . . . . . . .
. . . . . . . * . . . . . . . . . * . . . . . . .
. . . . . . . * . . . . . . . . . * . . . . . . .
. . . . . . . * . . . . . . . . . * . . . . . . .
. . . . . . . * . . . . . . . . . * . . . . . . .
. . . . . . . * . . . . . . . . . * . . . . . . .
. . . . . . . * . . . . . . . . . * . . . . . . .
. . . . . . . * . . . . . . . . . * . . . . . . .
. . . . . . . * . . . . . . . . . # . . . . . . .
. . . . . . . * . . . . . . . . . # . . . . . . .
. . . . . . . * . . . . . . . . . # . . . . . . .
. . . . . . . * # # # # # # # # # * . . . . . . .
. . . . . . . # . . . . . . . . . * . . . . . . .
. . . . . . . # . . . . . . . . . * . . . . . . .
. . . . . . . # . . . . . . . . . * . . . . . . .
. . . . . . . * . . . . . . . . . * . . . . . . .
. . . . . . . * . . . . . . . . . * . . . . . . .
. . . . . . . * . . . . . . . . . * . . . . . . .
. . . . . . . * . . . . . . . . . * . . . . . . .
. . . . . . . * . . . . . . . . . * . . . . . . .
. . . . . . . * . . . . . . . . . * . . . . . . .
. . . . . . . * . . . . . . . . . * . . . . . . .
. . . . . . . * . . . . . . . . . * . . . . . . .
& . . . . . . * . . . . . . . . . * . . . . . . .
