25 25
& . . . . + * . . . + & . . * . . . . . . . . . &
. . * . . . + . . * . . . . + . . * . . . + . . .
. . . * . . . . . . + . . * . . + . . . . . . . .
. * + . . . . * + . . * . . . . . . . + . . . . *
. + . . . + . . . . . + . . . + * . . . . . * . .
+ * . . . . . . * . . . . . . * . . . . + * . . .
. . . * * . . + . . . . * . + . * . . . + . . . .
. . . * . + . . . + * . . . . * . . . . + . * . .
. . * . . . . * . . + . . . * . . . . . * + . . .
. . + . . * . . . . . * . . + . . * . . . . . * .
. . . * . . + * . + . * . . . . + . . . + * . . .
& . * . . . . . . . . . + . . . * . . + . . . * .
+ . . . * . . . . . . * . . . + . . . . * . . . &
. . . . . . + . . . * . . + . . . * . + . . . . *
. * + . . * . . . . * . . . . * . . . . . . . . .
. . . . . . . + . . . * . . + . * * * + . . . . .
. . + . . . * . . . . + . . . . . . . . * . + . .
. . * + . . . * . . + . . . * . + . . . . * . . .
. . . * . . + . . . . * . . . . . . + . . + . . .
. . . + . . . . * . . + . . . . . . * . . . . . *
. * . . . * . + . . . . * . . . + . * . . . . . .
. . . . * + . . . * . . + . . * . . . * . + . . .
. + . . * . . . * . . . . . . . + * + * * . . . .
. * . . . * . + . . . + . * . . . . * . . . . . .
+ . & . . + . . * . . . & . . * . . + . . * . . &