25 25
& . . . . + . . . . + & . . . . . . . . . . . . &
. . . . . . + . . . . . . . . . . . . . . + . . .
. . . . . . . . . . + . . . . . . . . . . . . . .
. . . . . . . . . . . . . . . . . . . + . . . . .
. . . . . + . . . . . . . . . + . . . . . . . . .
. . . . . . . . . . . . . . . . . . . . . . . . .
. . . . . . . + . . . . . . + . . . . . + . . . .
. . . . . . . . . + . . . . . . . . . . . . . . .
. . . . . . . . . . . . . . . . . . . . . . . . .
. . + . . . . . . . . . . . + . . . . . . . . . .
. . . . . . . . . + . . . . . . . . . . + . . . .
& . . . . . . . . . . . + . . . . . . . . . . . .
+ . . . . . . . . . . . . . . + . . . . . . . . &
. . . . . . + . . . . . . . . . . . . + . . . . .
. . + . . . . . . . . . . . . . . . . . . . . . .
. . . . . . . + & . . . + . & . . . . + . . . . .
. . + . . . . . . . . . . . . . . . . . . . . . .
. . . + . . . . . . . . . . . . + . . . . . . . .
. . . . . . + . . . . . . . . . . . + . . . . . .
. . . . . . . . . . . + . . . . . . . . . . . . .
. . . . . . . + . . . . . . . . + . . . . . . . .
. . . . . . . . . . . . + . . . . . . . . . . . .
. + . . . . . . . . . . . . . . . . . . . . . . .
. . . . . . . + . . . + . . . . . . . . . . . . .
+ . & . . . . . . . . . & . . . . . + . . . . . &