25 25
& . . . . + . . . . + & . . . . . . . . . . . . &
. . . . . . + . . . . . . . + . . . . . . + . . .
. . . . . . . . . . + . . . . . + . . . . . . . .
. . + . . . . . + . . . . . . . . . . + . . . . .
. + . . . + . . . . . + . . . + . . . . . . . . .
+ . . . . . . . . . . . . . . . . . . . + . . . .
. . . . . . . + . . . . . . + . . . . . + . . . .
. . . . . + . . . + . . . . . . . . . . + . . . .
. . . . . . . . . . + . . . . . . . . . . + . . .
. . + . . . . . . . . . . . + . . . . . . . . . .
. . . . . . + . . + . . . . . . + . . . + . . . .
& . . . . . . . . . . . + . . . . . . + . . . . .
+ . . . . . . . . . . . . . . + . . . . . . . . &
. . . . . . + . . . . . . + . . . . . + . . . . .
. . + . . . . . . . . . . . . . . . . . . . . . .
. . . . . . . + . . . . . . + . . . . + . . . . .
. . + . . . . . . . . + . . . . . . . . . . + . .
. . . + . . . . . . + . . . . . + . . . . . . . .
. . . . . . + . . . . . . . . . . . + . . + . . .
. . . + . . . . . . . + . . . . . . . . . . . . .
. . . . . . . + . . . . . . . . + . . . . . . . .
. . . . . + . . . . . . + . . . . . . . . + . . .
. + . . . . . . . . . . . . . . + . + . . . . . .
. . . . . . . + . . . + . . . . . . . . . . . . .
+ . & . . + . . . . . . & . . . . . + . . . . . &