25 25
. . . . . + . . . . + . . . . . . . . . . . . . .
. . . . . . + . . . . . . . . . . . . . . + . . .
. . . . . . . . . . + . . . . . . . . . . . . . .
. . . . . . . . . . . . . . . . . . . + . . . . .
. . . . . + . . . . . . . . . + . . . . . . . . .
. . . . . . . . . . . . . . . . . . . . . . . . .
. . . . . . . + . . . . . . + . . . . . + . . . .
. . . . . . . . . + . . . . . . . . . . . . . . .
. . . . . . . . . . . . . . . . . . . . . . . . .
. . + . . . . . . . . . . . + . . . . . . . . . .
. . . . . . . . . + . . . . . . . . . . + . . . .
. . . . . . . . . . . . + . . . . . . . . . . . .
+ . . . . . . . . . . . . . . + . . . . . . . . .
. . . . . . + . . . . . . . . . . . . + . . . . .
. . + . . . . . . . . . . . . . . . . . . . . . .
. . . . . . . + . . . . + . . . . . . + . . . . .
. . + . . . . . . . . . . . . . . . . . . . . . .
. . . + . . . . . . . . . . . . + . . . . . . . .
. . . . . . + . . . . . . . . . . . + . . . . . .
. . . . . . . . . . . + . . . . . . . . . . . . .
. . . . . . . + . . . . . . . . + . . . . . . . .
. . . . . . . . . . . . + . . . . . . . . . . . .
. + . . . . . . . . . . . . . . . . . . . . . . .
. . . . . . . + . . . + . . . . . . . . . . . . .
+ . . . . . . . . . . . . . . . . . + . . . . . .