25 25
. * * . . . . . . . . . . . . . . . . . . # . . .
. . * * . . . . . . # . . . . . . # . . . . . . .
. . . * * . . . . . . . . . . . . . . . . . . . .
. . . . * . . . # . . . . . . # * . . . * # . . .
. . . . . . # . . . . . . . . # * . . . * # . . .
. . . # . . . . . . . . . . . # * * * * * # . . .
. . . . . . # . . # . . . . . # # # # # # # . . .
. . . . . . . . . . . . # . . . . . # . . . # . .
. . . . . . . . . . . . . . . . . . . . . # . . .
. # . * . # . * * . # . * . # . * * . # . * . # .
. # . * . # . * * . # . # . # . * * . # . * . # .
. . . * . . . . . . . . * . . . . . . . . * . . .
# * * * # . . . . # # * * * # # . . . . # * * * #
. . . * . . . . . . . . * . . . . . . . . * . . .
. # . * . # . * * . # . # . # . * * . # . * . # .
. # . * . # . * * . # . * . # . * * . # . * . # .
. . . . . . . . . . . . . . . . . . . . . . . . .
. . . . . . . . # # # # # # . . . . # . . . . . .
. . . # . . # . # * * * * # . . . # . . . . # . .
. . # . . . . . # * . . * # . . . . . . # . . . .
. . . . . # . . # * . . * # . . . # . . . . . # .
. . . . . . . . # * . . * # . . . . . . * . . . .
. . . . . . . . . . . . . . . . . . . . * * . . .
. . # . . # . . . . . . . . # . . . . . . * * . .
. . . . . . . . . . . . . . . # . . . . . . * * .