25 25
. * * . . . . . . . . . . . . . . . . . . # . . .
. . * * . . . . . . # . . . . . . # . . . . . . .
. . . * * . . . . . . . . . . . . . . . . . . . .
. . . . * . . . # . . . . . . # * & & & * # . . .
. . . . . . # . . . . . . . . # * & & & * # . . .
. . . # . . . . . . . . . . . # * * * * * # . . .
. . . . . . # . . # . . . . . # # # # # # # . . .
. . . . . . . . . . . . # . . . . . # . . . # . .
. . . . . . . . . . . . . . . . . . . . . # . . .
. # . * . # . * * . # . * . # . * * . # . * . # .
. # . * . # . * * . # . # . # . * * . # . * . # .
. . . * . . . . . . . . * . . . . . . . . * . . .
# * * * # . . . . # # * * * # # . . . . # * * * #
. . . * . . . . . . . . * . . . . . . . . * . . .
. # . * . # . * * . # . # . # . * * . # . * . # .
. # . * . # . * * . # . * . # . * * . # . * . # .
. . . . . . . . . . . . . . . . . . . . . . . . .
. . . . . . . . # # # # # # . . . . # . . . . . .
. . . # . . # . # * * * * # . . . # . . . . # . .
. . # . . . . . # * & & * # . . . . . . # . . . .
. . . . . # . . # * & & * # . . . # . . . . . # .
. . . . . . . . # * & & * # . . . . . . * . . . .
. . . . . . . . . . . . . . . . . . . . * * . . .
. . # . . # . . . . . . . . # . . . . . . * * . .
. . . . . . . . . . . . . . . # . . . . . . * * .
