25 25
& * * . . . . . . . . . . . . . . . . . . # . . &
. . * * . . . . . . # . . . . . . # . . . . . . .
. . . * * . . . . . . . . . . . . . . . . . . . .
. . . . * . . . # . . . . . . # * . . . * # . . .
. . . . . . # . . . . . . . . # * . & . * # . . .
. . . # . . . . . . . . . . . # * * * * * # . . .
. . . . . . # . . # . . . . . # # # # # # # . . .
. . . . . . . . . . . . # . . . . . # . . . # . .
. . . . . . . . . . . . . . . . . . . . . # . . .
. # . * . # . * * . # . * . # . * * . # . * . # .
. # . * . # . * * . # . # . # . * * . # . * . # .
. . . * . . . . . . . & * & . . . . . . . * . . .
# * * * # . . . . # # * * * # # . . . . # * * * #
. . . * . . . . . . . & * & . . . . . . . * . . .
. # . * . # . * * . # . # . # . * * . # . * . # .
. # . * . # . * * . # . * . # . * * . # . * . # .
. . . . . . . . . . . . . . . . . . . . . . . . .
. . . . . . . . # # # # # # . . . . # . . . . . .
. . . # . . # . # * * * * # . . . # . . . . # . .
. . # . . . . . # * & & * # . . . . . . # . . . .
. . . . . # . . # * . . * # . . . # . . . . . # .
. . . . . . . . # * . . * # . . . . . . * . . . .
. . . . . . . . . . . . . . . . . . . . * * . . .
. . # . . # . . . . . . . . # . . . . . . * * . .
& . . . . . . . . . . . . . . # . . . . . . * * &
