40 40
. . + + + * + + + * . . . . . . . . . . . . . . . . . . . . . . . . . . . . . . 
. . + + + * + . + * . . . . . . . . . . . . . . . . . . . . . . . . . # * . . . 
. . + + + * # . # * . . . . . . . . . . . . . . . . . . . . . . . . . # * . . .
. . . . . . . . . * . . . . . . . . . . . . . . . . . . . . . . . . . # * . . . 
* * * * * * * * . * . . . . . . . . . . . . . . . . . . . . . . . . . # * + . . 
. . . . . . . . . * . . . . . . . . . . . . . . . . . . . . . . . . . # * + . . 
. . . . . . . . . # . . . . . . . . . . . . . . . . . . . . . . . . . # * + + + 
# * # * # * # * . * . . . . . . . . . . . . . . . . . . . . . . . . . # * * * * 
. . . . . . . . . # . . . . . . . . . . . . . . . . . . . . . . . . . # # # # # 
* # * . * # * # * # . . . . . . . . . . . . . . . . . . . . . . . . . . . . . . 
. . . . . . . . . . . . . . . . . . . . . . . . . . . . . . . . . . . . . . . . 
. . . . . . . . . . . . . . . . . . . . . . . . . . . . . . . . . . . . . . . . 
. . . . . . . . . . . . . . . . . . . . . . . . . . . . . . . . . . . . . . . . 
. . . . . . . . . . . . . . . . . . . . . . . . . . . . . . . . . . . . . . . . 
. . . . . . # # # . . . . . . . . . . . . . . . . . . . . . . . . . . . . . . . 
. . . . . . # * # . . . . . . . . . . . . . . . . . . . . . . . . . . . . . . . 
. . . . . . # # # . . . . . . . * # * * * * # * . . . . . . . . . . . . . . . . 
. . . . . . . . . . . . . . . . # . # . . # . # . . . . . . . . # # # . . . . . 
. . . . . . . . . . . . . . . . * # * + . * # * . . . . . . . . # * # . . . . . 
. . . . . . . . . . . . . . . . * . . . . + . * . . . . . . . . # # # . . . . . 
. . . . . . . . . . . . . . . . * . + . . . . * . . . . . . . . . . . . . . . . 
. . . . . . . . . . . . . . . . * # * . + * # * . . . . . . . . . . . . . . . . 
. . . . . . . . . . . . . . . . # . # . . # . # . . . . . . . . . . . . . . . . 
# # # # # . . . . . . . . . . . * # * * * * # * . . . . . . . . . . . . . . . . 
* * * * # . . . . . . . . . . . . . . . . . . . . . . . . . . . . . . . . . . . 
+ + + * # . . . . . . . . . . . . . . . . . . . . . . . . . . . . . . . . . . . 
. . + * # . . . . . . . . . . . . . . . . . . . . . . . . . . . . . . . . . . . 
. . + * # . . . . . . . . . . . . . . . . . . . . . . . . . . . . . . . . . . . 
. . . * # . . . . . . . . . . . . . . . . . . . . . . . . . . . . . . . . . . . 
. . . * # . . . . . . . . . . . . . . . . . . . . . . . . . . . . . . . . . . . 
. . . * # . . . . . . . . . . . . . . . . . . . . . . . . . # * # * # * . * # * 
. . . . . . . . . . . . . . . . . . . . . . . . . . . . . . # . . . . . . . . . 
. . . . . . . . . . . . . . . . . . . . . . . . . . . . . . * . * # * # * # * # 
. . . . . . . . . . . . . . . . . . . . . . . . . . . . . . # . . . . . . . . . 
. . . . . . . . . . . . . . . . . . . . . . . . . . . . . . * . . . . . . . . . 
. . . . . . . . . . . . . . . . . . . . . . . . . . . . . . * . * * * * * * * * 
. . . . . . . . . . . . . . . . . . . . . . . . . . . . . . * . . . . . . . . . 
. . . . . . . . . . . . . . . . . . . . . . . . . . . . . . * # . # * + + + . . 
. . . . . . . . . . . . . . . . . . . . . . . . . . . . . . * + . + * + + + . . 
. . . . . . . . . . . . . . . . . . . . . . . . . . . . . . * + + + * + + + . . 
