32 32
. * . . . . . * . * . . . * . . . . . . . . . # * . * . . * + + 
. . . . * . # . . . . * . . . * . . . # . . * . . . . * . . * + 
* . . * . . . . * . . . . # . . * . . . . . . . . * . . # . . . 
. . . # . * . . . * . . * . * . . . . # . . . * . . * . * * . * 
. . * . . . . * . . . . . . . . * . . . . . . . . . . . . . . . 
* . . . * # # # # # * . . * . . . . . . # . . . * . * . * . * . 
. . * . . # * + * # . * . . . * . . . . . . . . . . # . . . # . 
. # . . . # + + + . . . . . . # . * . . . # . . . * . * . * . * 
* * . . * # * + . . . # # . * . . . . . . . . . . . * . . . . . 
* . . . . # # . . . + * # . . * . . . . . # . . . . . . * . . * 
. . . * . . . . . + + + # * . . . . * . . . . . . * . * . . . . 
. * . . . * . . # * + * # . . . * . . . . . # . . . . . . * # . 
. . . * . . * . # # # # # . * . # . * . . . . . . . * . * . * . 
. . * . . . . . . * . . . . . . . * . * . . . # . . . . . . . . 
* # . . . * . * . . . . * . . * . . . . . . . . . . . * . * . . 
. . * . . . . . . * . . . . . . . . * . * . . . # . . . . . . * 
. . . . * . . . . . . * . . * . . . . . . . . . . . . . * . . . 
. * . . . # . * . . . . . . # . . * . * . . . . . # . . . . * . 
. . . * . * . . # . * . . * . . . . . . # * . . . . . . * . . . 
. * . . . . . * . . . . . . . . * . * . . . . . . # . . . . . * 
. . # * . . . . . * . * . . * . . . . * . . * . . . . . . . * # 
* . . . . * . * . . . . * . . . * # . . * . . . . . # . . . . . 
. . * . . . # . . * . # . . * . . . * . . . . * . . . . . . * . 
* . . . * . . * . . . * . . . . . * . . . * . . . . # . . . . . 
. . . . . . . . . . . . . * # * . . . * . . . . . . . . . . . * 
. # # # . # # # . . * . . . . . . * . . . # * . . . . # . . . . 
. # . # . # . # . . . . * . * . . . . * . . . . * . . . . . . . 
. . . . . . . . . . . . . . . . * . . . . * . . . . . . # . . . 
* * * * * . # # . . . * # * . . . . * . . . . . . . . . . . . . 
. . . . . . . # . . . . . . . * . . . . * . . * . * . . . # . . 
. . . . * . # # . . * . * . . . . * # . . . * . . . . . . . . . 
+ + + + * . . . . . . . . . * . . . . * . . . . * . * . . . # . 