15 15
& * . . . . . * . . . * . . &
. * . * * * . . . * . . . * .
. * . . . * * . * * * * * * .
. . . * . * . . . . . * . . .
* * . * . . . * . * . . . * *
. . . * * * . . . * . * . . .
. * * * . . . * . . . * * * .
. . . . . * . * * * * * . . .
* * * . * * . * . . . . . * *
. . . . . * . . . * * . * * *
. * * * . * * . * * . . . * *
. * * . . . . . . . . * . . .
. . . . * . * * . * * * . * .
* * * . * . * . . . * . . * .
& . . . * . . . * . . . * * &