20 21
. . . . . . . . . . . . . . . . . . . .
. * * # # * * . * * # # * * . * * * * .
. * * + + * * . * * # # * * . * * * * .
. * * * * * * . * * + + * * . * * + # .
. . . . . & * . * * + + * * . * * + # .
. * * * * * * . * * * * * * & * * * * .
. * * * * * * . * * * * * * * * * * * .
. # # + + * * . * * * & . . . . . . . .
. # # + + * * . * * * * * * * * * * * .
. * * * * * * & * * + + + * * * * * * .
. * * * * * * * * * + + + # # # # # # .
. . . . . . . . & * + + + * * * * * * .
. * * * * * * * * * * * * * * * * * * .
. * * * * * * * & * & . . . . . . . . .
. * * + + + * * . * * * * * * * * * * .
. * * + + + * * . * * * * * * & * * * .
. * * + + + * * . * * + + * * . * * * .
. * * # * * * * . * * + + * * . * + # .
. * * # # # * * . * * # # * * . * * * .
. * * * * # * * . * * # # * * . * * * .
. . . . . . . . . . . . . . . . . . . .