17 27
+ + + + . . + + + + + . . + + + +
+ + . . . . . . . . . . . . . + +
. . & * . . * & . & * . . * & . .
* * * * # # * * * * * # # * * * *
. . . . . . . . . . . . . . . . .
. . . * & & * . . . * & & * . . .
# # # * * * * # # # * * * * # # #
. . . . . . . . . . . . . . . . .
. * & * . * & * . * & * . * & * .
# * * * # * * * # * * * # * * * #
. . . . . . . . . . . . . . . . .
. . . . . . . . . . . . . . . . .
. . . . . . . . . . . . . . . . .
. # . # . # . # . # . # . # . # .
# . # . # . # . # . # . # . # . #
. * . * . * . * . * . * . * . * .
. . . . . . . . . . . . . . . . .
* . * . * . * . * . * . * . * . *
. . . . . . . . . . . . . . . . .
. * . * . * . * . * . * . * . * .
. . . . . . . . . . . . . . . . .
. . . . . . . . . . . . . . . . .
. # . # . # . # . # . # . # . # .
* . * . * . * . * . * . * . * . *
& . . & & . & . . . & . & & . . &
+ + . + + . + + . + + . + + . + +
+ + & + + & + + & + + & + + & + +